044444444444444444444444444444444444444444
004444000000096900006440004999900444000004
400000000009996000006400009440000040099004
400000000009996000006000000000000000000000
490000000009996000006000004000090990099004
400000000000096661666000004000900490009004
494000049400000040090000999909990000400004
494000094900000000000000009490000000499994
400000000000000000000000900000000004000004
404440004440040040444404000400000040000004
404040040004040040400000404000400490004004
404440040004040040400400040000040999000004
404004004440004499044400040000000449000004
400000000000000000000000000000000040000004
499444490000000000099000000090000004444044
409994400000490444499444400999009900000004
400000000000490000009000000090090049444444
400040000000400000990000400009000040000994
490044400000400005590000400940009940009994
499000400009990005500400409940044449900994
494444444444444444444444444444444444444444
494444444444444444444444444444444444444444
444444444444444444444444444444444444444444
444444444444444444444444444444444444444444

